#.#........#.....#..#..#.#......#........#......#.
#..#.............#.........##.........#..#.....##.
........##.....#.#..............................#.
............................#...........#........#
...................................#..............
.........#......................#.......#..#.....#
##.............#........#.........................
......#.........#............#................##..
......#.......#.........##.......#..#..#..........
#......#..#.................#..###...#....#.......
....##..............................#..#........#.
......#.#.....#........#..#...#...................
..#......#.#.#........#.........#.................
........##............#.#.................#......#
.#..............#....#...............#.#..#..#.#..
...#................#...#.........................
........#..............#...#......................
.#.................#.....#..............#.........
.......#........................#.#..............#
..#..........#........#....#..........#..........#
........#.#.............#.#........#..............
.#...#........................#...................
.......#...........#.#.#.......##............#...#
....##...#........#................#..............
..............................#...............#...
.#............#.......#..............#............
.....#.........#..............#...................
........#..#...#....#.#.................#.........
.............#.....................#..............
.#....#..............#.....#......................
..#.#............#.............#..................
....#..........#....#.........#...#........##.....
............................#.#.#.........#.#.....
......#...............#.................#.#.......
..........#.........#...........#....###.......#..
........#.........#............#..#..#....##......
.............#..#....#........................#...
..........#.#......#.....................##.......
......###....#.......#..#.#......#..#..........#..
.......###............#.#.#............#..........
..#........#.........#.......#...................#
.........#.#.....#......................#.........
#....#..#.#..#.......###....#.#.................#.
......#.........#.#...............................
...#....#.........##..#.....#......#..#.........#.
.......#........##.......#..#....##....#....#.....
..#....#.........#.....#......##.................#
#.#.......#.....#...........#.................#..#
........#......#.........................#.#.....#
.......#...#....##...........#.#.......#..........