.........##....................#......#...#.....#.
.#..#...#...............................#.........
#.............#..................#....#...........
..#......#...............#.....#...##.........#...
...#.....#....##....#.............................
....#.............#......#...##........#...#......
......#..........#....#....#......................
..........#.................#............#.....#..
.......#...#.......#.......#..........##.......#..
..................#..#...#.............#..#...#...
......#..................#......#..............##.
.......#.#...#..#...#............#...#....#.......
..............................................#...
..............................#..................#
...#.....................#...#...........##..#..#.
.#.....#.................#...#....................
.........##........#......#.#....#...#......##....
......#.......................#...#.......#.......
.........#.....#..........#...#.......#..#..#.....
...#............#.................................
........#.....#............................#......
......................................#...........
.........................##................#......
.#..........#....#.................#.........#....
.#................#...##.............#..........##
............................#.......#.#.........#.
...#...#.....#....................................
....##.......#.......#...................#........
......#..................#........#.......#.......
..#.....#..........................#.#............
...........#....#.................................
....#..#...........................#.....#........
..................##..............................
.....#..#.......##...#........##..................
...............................#.......#.......#..
.....#....##.#..##......#.....#...#...............
#.#.#...........#...#.................#....#...#..
#................#............#................#..
#....#...#..#.....................................
..#....#.##.#............#.........#...........#..
...........#...................................##.
...#.......#.........#...................#........
.....##...............................#.#......#..
......#............#.......................##...#.
....#.......#.....#...............................
........#........#.........#................#..#..
#.................................................
...........#.#..#.........#....#.#..#...........#.
....#............#..###......................#....
..#........#...............#.##...............#.#.