...#.................#..............#....#......#.
.....#.#...#....#....#.....#.#.......#.....#......
.....#..#........#....#......................#....
.....#....#..........#........#...................
...............#.#......#..###..............#.....
..#......#.............#...........###.....#.....#
..............#.......................#...........
#..............#........#.....#...#..#.#..........
.......................#..........................
........#..##..................#.#......#...#.....
......................................#.......#...
.....................#...#..#.......#.....#.......
.....................................##...#.....#.
.#................#.#..........#..........#....#..
...#....#..............#...........##.#....#..#...
...#...........#...........#...................##.
..........#..............#......#.#.........#.....
.....##....#.##..#...##...............#.......#.#.
#.#..#.....#.........................#........#...
.#.......#...#..#...##.....#.#......#.............
..................................#.....#...#.##..
#.......#..#.....#......#......#.#.....#......#...
..#............#.................#.....#......#...
.#..#..###..#.#....#..#........#.##...............
.............#............#..#..#.........#......#
......#.#........#.................#...#.........#
.......#.###..#..............##........#......#...
..##........#..#..#.....#........#......#.........
.......#..#..#............#.#...#.................
.......#........#.........#........#..............
....#........#..#..#............#.............#...
#.......#...#......##..........#.......#..........
##.........#.....#.....#.#...#....................
.....#............#...............................
..#.........#..........................#.....#....
..........#...#........#.....................#....
.............#..#....................#.#..........
.....#.............#.....#..............#....#....
......#...##..............#.....#..#..............
...................................#........#.....
...............................#........###....##.
....#.#......#.#..........#........#...#.....#....
............#..##..#...........##.................
.#........#......#....................#..#.......#
..##..#...#.................#..#......#..........#
#.....#.........#...##.##..........#.........#....
...#.#..#.....#....#........................#....#
#####...#....#.....##.#...............##..#.......
....................#...........##.......##.......
.#................#................#..............