..........................#..#....#...#...#.......
.................................#........#.#.....
...............#.##............#.##.#.#...........
#.........................#......#........#.......
.#..#.....#...............#..........#............
..#........................#..................#...
....#...#........#................##.........#....
...#..............#.##.##.................#.....#.
...#..#...................#..#....#...#....#......
........................##.....#.......#..#......#
#...............#.......#...........#.............
#..#....................#..............#..........
............#...#..................#...........#..
.............#..........................#......#..
.##...#..#....##...#.........#..#..........#......
.............#.............#........#.....#.......
............#............#................#.......
....#.........#..............#...............#...#
....#............................#................
..........#..#.......#........#....###......#.....
........................#...#....#....#.##...#....
........#..#...#........................#.........
....#....#.....#.....#......#....#.....#....#.#...
..........#........................##............#
............#...#......#..........................
..#...............#...#.....#..#.........#..#.....
........##........#...............................
..#....#.............#...#...................#....
....................#...#........##.#..........#..
....#...#.#....#..####..#...#.....................
..#....#....#........#...........#..........##....
#.#.............#...........#..........#.....#...#
.....#............................................
..............#...##.......#....#..#..#..........#
.................#...........................#.#..
#.....#....#.#......##.........................#..
.......#..#......##...#......#.....##..#..........
#..#.....................#....#..#..............#.
....#.....#..............#........................
..#........................#.....#................
............##..#....#......#...........#.....#...
..#........#......##...#.#..........#.....#.......
........#.....................#...#..............#
......................#...........................
...#...................#..........#.....#.##....#.
..........................................#.......
...#.....#.#...............#...#...........#......
....#......#.#......#.............#.##....#.......
#..........#..#............#...........#..........
..............................#.........#.........