..#....#...........#.........................##.#.
.............#.................##..#.......#.....#
.............#.......##......................#....
....................#..#.#.................#......
.............#...........#......#.....#.....#..#..
#.................................................
.............................................#....
.........#........................................
........#.#.................................#.....
.....#...#.............#................#.........
#........#..#......#...........#....#.....##..#...
..........#.................................#.....
...........##...................................#.
....##....#....................#...#.........#...#
.#....#..........................#................
....##......#.....................................
..........#.......#.......##...#.........#..#.....
................##.................##.....#.#....#
.........................................#........
..................#...............#...............
.#.......#.....##.......#....##.....#.....#.#.....
#.........#...#...#.........#......#..#...........
#.......#......#.........#.....................#..
#.......#.....#....#..............................
#....#...#.#......................................
.............#.....................#.....#....#...
..#..........#..................#................#
......#................#.........###.#............
....#...............................#....#........
........................#.........................
#.#..#.#.......................#..................
#.#........#.......#.#......#.##.#......#.#...#...
..#.......................#.#.......#.............
..................................................
........#.....###.........#.....#....#.#...##.....
.......#......#.......#.#........#............#...
..##..............#.....#.#...........#...........
..............##.#.........#.......#..........#...
..#...........#............#......................
.......................#...#.#...#.#.....#..#..#..
............#..............................#......
......#.............#.##..#..#...............#....
...#.........................................#....
.#........#.....#.....#..................#....#...
#......#.....................#..#........#........
..#.....................##..........#...#.....#...
.......#.#....#......#.....#.....................#
.......................#...........##.........#...
.....##..........#......#.........................
..........#.............#.............#........#..