..................#....#....#...#...#.............
.#.......................#.......#.......#........
#......#...#...##....#.......................#.#..
..#......#.....#.......................#..........
.....#....#.#......#..#.....#....#................
#...#.#..#.##......#...............#..........###.
......#......#......#..........#.......#...#....#.
#......#...........#.#...............#....#..#..#.
..............................##..................
##......#........................#..............#.
...#..#.#............#.....#.....#.#.#.#.##......#
..#................#................#..........#..
...................#.#........................#...
.............#..#......#.................#.#......
................#..#..........#.#.............#...
........................#.........#......#.......#
............#.#.......#............#.......#.#....
.#.........................#.#.............#...#..
................#..................#....##........
.....#........#.....#...#.........................
.................#..#....#.....#........#.........
......................#...................#...#...
...#..........#...#......#.........#..##..........
.........................#.#.....#...#............
.............#.........#...#..#.......#..........#
......#.#..#.........#.....#..#....#............#.
.....................#...................#...#....
.......#.............#........##......#..........#
#.........#.......#.........#........#............
.......#.......#........#.....#...................
..................#.....##.....#..#.............##
..................#.........#....#.#.#.....#......
.#...#....#...##.............#..###.....#.........
..#.........#.....#.........#.................##..
#................#...................##.#....#....
.................#........................#....#..
...............#..................................
#............#...#.................#..#...........
.................#....#...............#.......#...
.#..............................#..#.......#......
.......#........#.........#...#...................
......#.........#..........#........###...........
#.#..................#............#.#...#.........
...#..................#..................#....#...
..........................#.....#..#..#.....#...#.
....................#.....................#.......
..................#.........#.........#...##......
#..##......#...#.....#......#.....#..#............
....#.........#.....#.....#.....#.................
......##......#...##..............................